HHHHHHHHHHHHHHHHHHHH
HHHHgHHHHHHHFHHHHHHH
HHHgggHHHHHHHHHHHHHH
HHgggggHHHHHHHHHHHHH
HHHgggHHHHgHHHHHHHHH
HHHHgHHHHgggHHHHHHHH
HHHoHHHHgggggHHHoHHH
HHHHHHHHHgggHHHHHHHH
BBHHHHHHHHgHHHHHHH==
BBHHHHHHHHHHHHHHHH==
BBHHHHHHHHHHoHHHHH==
HHHHHHHHHHHHHHHHHHHH
HHHHHHgHHHHHHHHHHFHH
HHHHHgggHHHHHHHgHHHH
HHHHgggggHHHHHgggHHH
HHHHHgggHHoHHgggggHH
HHHHHHgHHHHHgggggggH
HFHHHHHHHHHHHgggggHH
HHoHHHHHHHHHHHgggHHH
HHHHHHHHHHHHHHHgHHHH