PPPPPqqPPPPPPqqPPPPP
PPPPqqPPPPPPPPqqPPPP
PPPqqPPPPPPPPPPqqPPP
PPqqPPPPPPoPPPPPqqPP
PqqPPPPPPPPPPPPPPqqP
qqPPPPPPPPPPPPPPPPqq
PPPPPPPPPPPPPPPPPPPP
PPPPPPPqqqqqqqPPPPPP
CCPPPPPqPPPPPqPPPPbb
CCPPPPPqPPPPPqPPPobb
CCPPPPPqPPPPPqPPPPbb
PPPPPPPqPPPPPqPPPPPP
PPPPPPPqqqqqqqPPPPPP
PPPPPPPPPPPPPPPPPPPP
qqPPPPPPPPPPPPPPPPqq
PqqPPPPPPPPPPPPPPqqP
PPqqPPPPPPoPPPPPqqPP
PPPqqPPPPPPPPPPqqPPP
PPPPqqPPPPPPPPqqPPPP
PPPPPqqPPPPPPqqPPPPP