EEEEErrrEEEErrrEEEEE
EEEEErrrEEEErrrEEEEE
EEEEErrrEEEErrrEEEEE
EEEEErrrEooErrrEEEEE
rrrrrrrrEEEErrrrrrrr
rrrrrrrrEEEErrrrrrrr
rrrrrrrrEEEErrrrrrrr
EorEEEEEEEEEEEEEEEEE
EEEEEEEEEEEEEEEEEEAA
EEEEEEEEEEEEEEEEEFAA
EEEEEEEEEEEEEEEEEEAA
EorEEEEEEEEEEEEEEEEE
rrrrrrrrEEEErrrrrrrr
rrrrrrrrEEEErrrrrrrr
rrrrrrrrEEEErrrrrrrr
EEEEErrrEooErrrEEEEE
EEEEErrrEEEErrrEEEEE
EEEEErrrEEEErrrEEEEE
EEEEErrrEEEErrrEEEEE
EEEEErrrEEEErrrEEEEE