xxxxxxxxxxxxxxxxxxxx
OOOOOOOOOOOOOOOOOOOO
OOOOOOOOOOOOOOOOOOOO
xxxxxxOOOOxxxxxOOOxx
xxxxxxOOOOxxxxxOOOxx
OOOOOOOOOOOOOxxOOOxx
OOOOOOOOOOOOOxxOOOxx
OOOOOOOOOOOOOxxOOOxx
OOOOOOOOOOOOOxxOOOxx
OOOOOOOOOOOOOxxOOOaa
OOOOOOOOOOOOOxxOOOaa
OOOOOOOOOOOOOxxOOOaa
OOOOOOOOOOOOOxxOOOxx
OOOOOOOOOOOOOxxOOOxx
OOOOOOOOOOOOOxxOOOxx
xxxxxxOOOOxxxxxOOOxx
xxxxxxOOOOxxxxxOOOxx
OOOOOOOOOOOOOOOOOOOO
OOOOOOOOOOOOOOOOOOOO
xxxxxxxxxxxxxxxxxxxx