UUyUUUUUUUUUUUUUUyUU
UFyUUUUUUU*UUUUUUyFU
yyyUUUUUUUUUUUUUUyyy
UUUUUUUUUUUUUUUUUUUU
UUUUUUUUUUUUUUUUUUUU
UUUUUUUUUUUUUUUUUUUU
UUUUUUUUUyyUUUUUUUUU
UUUUUUUUUyyUUUUUUUUU
UUUUUUUUUyyUUUUUUUUU
UUUUUUyyyyyyyyUUUUUU
UUUUUUyyyyyyyyUUUUUU
UUUUUUUUUyyUUUUUUUUU
UUUUUUUUUyyUUUUUUUUU
UUUUUUUUUyyUUUUUUUUU
UUUUUUUUUUUUUUUUUUUU
UUUUUUUUUUUUUUUUUUUU
UUUUUUUUUUUUUUUUUUUU
yyyUUUUUUUUUUUUUUyyy
UFyUUUUUU*UUUUUUUyFU
UUyUUUUUUUUUUUUUUyUU